CFXGD	CFXGD
KUMPN	KUMPN
KSSOJ	CFXGD
EMGNT	EMGNT
DCLSL	EMGNT
PFVNH	PFVNH
NJJJK	NJJJK
LYETM	EMGNT
EHCHF	CFXGD
WMMMB	CFXGD
SDIDY	NJJJK
IDJRQ	NJJJK
KCJPN	NJJJK
UALBL	EMGNT
FSSVX	PFVNH
MDAXY	NJJJK
VCPUC	PFVNH
GJAFJ	PFVNH
WSIQS	CFXGD
ADHXE	KUMPN
